DDDDDDDDDDDDDDDDDDDDDDDDDDDDDDDD
DDDDWWWWWWWWWWWWWWWWWWWWWWWGGGSS
WWWWWWWWWWWWWWWWWWWWWWWWWWWGGG1S
WWWWWWWWWWWWWWWWWWWWWWWWWWWGGGGG
WWWWWWWWWWWWWWWWWWWWWWWWWWWWWWWW
WWWWWWWWWWWWWWWWWWWWWWWWWWWWWWWW
WWWWWWWWWWWWWWWWWWWWWWWWWWWWWWWW
WWWWWWWWWWWWWWWWWWWWWWWWWWWWWWWW
WWWWWWWWWWWWWWWWWWWWWWWWWWWWWWWW
WWWGGGGGGGGGGGGGGGGGGGGGGGGGGGGG
GGGGGGGGGGGGGGGGGGGGGGGGGGGGGGGG
GGGGGGGGGGGGGGGGGGGGGGGGGGGGGGGG
SSSSGGGGGGGGGGGGGGGGGGGGGGGGGGGG
S2GGGGGGGGGGGGGGGGGGGGGGGGGGGGGG
SSSSSSSSSSSSSSSSSSSGGGGGGGGGGGGG

===
1 - MAP1_1 @ 28,22
2 - MAP1_2 @ 7,7
