DDDDDDDDDDDDDDDDDDDDDDDDDDDDDDDD
DDDDWWWWWWWWWWWWWWWWWWWWWWW$GGSS
WWWWWWWWWWWWWWWWWWWWWWWWWWWGGG1S
WWWWWWWWWWWWWWWWWWWWWWWWWWWGGGGG
WWWWWWWWWWWWWWWWWWWWWWWWWWWWWWWW
WWWWWWWWWWWWWWWWWWWWWWWWWWWWWWWW
WWWWWWWWWWWWWWWWWWWWWWWWWWWWWWWW
WWWWWWWWWWWWWWWWWWWWWWWWWWWWWWWW
WWWWWWWWWWWWWWWWWWWWWWWWWWWWWWWW
WWWGGGGGGGGGGGGGGGGGGGGGGGGGGGGG
GGGGGGGGGGGGGGGGGGGGGGGGGGGGGGGG
GGGGGGGGGGGGG$G$GGGGGGGGGGGGGGGG
SSSSGG$GGGGGGGGGGGGGGGGGGGGGGGGG
S2GGGGGGGGGGGGGGGGGGG$GGGGGGGGGG
SSSSSSSSSSSSSSSSSSSGGGGGGGGGGGGG

===
1 - MAP1_1 @ 28,22
2 - MAP1_2 @ 7,7
