SSSSSSSSSSSSSSSSSSSSSS
SGGGGGGGGSGGGGGGGGGGGS
SG$G*GGGSGGGGGGGGGGGGS
SGGGGGGSGGGGGGGGGGGGGS
SGGGGGS$SG$GGGGGGGGGGS
SGGGGGGGGGGGGGGGGGGGGS
SGGG$$GGGGGGGGGGGGGGGS
SGGG$$GG$GGGGGGGGGGGGS
SGGG$$GGGGGGGGGGGGGGGS
SGGG$$GGGGGGGGGGGGGGGS
SGGG$$GGGGGGGGGGGGGGGS
SGGG$$GGGGGGGGGGGGGGGS
SGGG$$GGGGGGGGGGGGGGGS
SGGG$$GGGGGGGGGGGGGGGS
SGGGGGGGGGGGGGGGGGGGGS
SGGGGGGGGGGGGGGGGGGGGS
SGGGGGGGGGGGGGGGGGGGGS
SGGGGGGGGGGGGGGGGGGGGS
SGGGGGGGGGGGGGGGGGGGGS
SGGGGGGGGGGGGGGGGGGGGS
SGGGGGGGGGGGGGGGGGGGGS
SSSSSSSSSSSSSSSSSSSSSS
===
