SSSSSSSSSSSSSSSSSSSSSS
SGGGGGGGGGGGGGGGGGGGGS
SGGG*GGGGGGGGGGGGGGGGS
SGGGGGGGGGGGGGGGGGGGGS
SGGGGGGGGGGGGGGGGGGGGS
SGGGGGGGGGGGGGGGGGGGGS
SGGGGGGGGGGGGGGGGGGGGS
SGGGGGGGGGGGGGGGGGGGGS
SGGGGGGGGGGGGGGGGGGGGS
SGGGGGGGGGGGGGGGGGGGGS
SGGGGGGGGGGGGGGGGGGGGS
SGGGGGGGGGGGGGGGGGGGGS
SGGGGGGGGGGGGGGGGGGGGS
SGGGGGGGGGGGGGGGGGGGGS
SGGGGGGGGGGGGGGGGGGGGS
SGGGGGGGGGGGGGGGGGGGGS
SGGGGGGGGGGGGGGGGGGGGS
SGGGGGGGGGGGGGGGGGGGGS
SGGGGGGGGGGGGGGGGGGGGS
SGGGGGGGGGGGGGGGGGGGGS
SGGGGGGGGGGGGGGGGGGGGS
SSSSSSSSSSSSSSSSSSSSSS
===
