SSSSSSSSSSSSSSSSSSSSSS
SGGGGGGSGGGGGGGGGGGGGS
SGGG*GGSGGGGGGGGGGGGGS
SGGGGGGSGGGGGGGGGGGGGS
SSSSSSSSGGGGGGGGGGGGGS
SGGGGGGGGGGGGGGGGGGGGS
SGGGGGGGGGGGGGGGGGGGGS
SGGGGGGGGGGGGGGGGGGGGS
SGGGGGGGGGGGGGGGGGGGGS
SGGGGGGGGGGGGGGGGGGGGS
SGGGGGGGGGGGGGGGGGGGGS
SGGGGGGGGGGGGGGGGGGGGS
SGGGGGGGGGGGGGGGGGGGGS
SGGGGGGGGGGGGGGGGGGGGS
SGGGGGGGGGGGGGGGGGGGGS
SGGGGGGGGGGGGGGGGGGGGS
SGGGGGGGGGGGGGGGGGGGGS
SGGGGGGGGGGGGGGGGGGGGS
SGGGGGGGGGGGGGGGGGGGGS
SGGGGGGGGGGGGGGGGGGGGS
SGGGGGGGGGGGGGGGGGGGGS
SSSSSSSSSSSSSSSSSSSSSS
===
