GGGGSSWWGSSGGGSSGGGS
GGGGSSWWGGGGGGGGGGGS
GGGGGWWWSGGGGGGGGGGS
GSGGGWWWWWSGGGGGGGSS
GGGGSDDDWWSSSSGGGGSS
GGGGSSDDDDDDDSGSGGGS
SSSGSSDDDDDSSSGGSSSS
GSGGWSWWSSSSGGGGGSGS
GSGGWWWWSGGGGGGGGGGSGGG
GSGGSWWWSGSSSGGGGGGGG*G
GSSSSSWWSGS SSSSSSSSGGG
GSGGWWWWSGS
GSGGWWWWSGS
GGGGSDDDSSS
